NO  ./textures/wall_north_128.xpm
SO  ./textures/wall_south_128.xpm
WE  ./textures/wall_west_128.xpm
EA  ./textures/wall_east_128.xpm

DO  ./textures/gate_x256.xpm

SQ0 ./textures/sprite_x256_0.xpm
SQ1 ./textures/sprite_x256_1.xpm
SQ2 ./textures/sprite_x256_2.xpm
SQ3 ./textures/sprite_x256_3.xpm

C   40,40,40
F   70,8,8


             111      1111     111
        11111101111111100111111101
        10000000001100000000000011
        10110C000111000000C000001
        10010000000000000C0000001
111111111011000001110000000000001
1000000000110000011101111D1111111
11110111111111011100000010C01
11110111111111011101010010001
1100000011C101011100000010001
10000000000000000000000000N01
10000000000000001101010010001111
11000001110101011111011110001
11110111 1110101 101111C10001
11111111 1111111 111111111111


