NO ./textures/wall_north_128.xpm
SO ./textures/wall_south_128.xpm
WE ./textures/wall_west_128.xpm
EA ./textures/wall_east_128.xpm

F  40,40,40
C  70,8,8



             111      1111     111
        11111101111111100111111101
        10000000001100000000000011
        1011000001110000000000001
        1001000000000000000000001
111111111011000001110000000000001
100000000011000001110111111111111
11110111111111011100000010001
11110111111111011101010010001
11000000110101011100000010001
10000000000000001100000000W01
10000000000000001101010010001111
11000001110101011111011110001
11110111 1110101 101111010001
11111111 1111111 111111111111


