NO ./textures/fake_wall_north.xpm
SO ./textures/fake_wall_south.xpm
WE ./textures/fake_wall_west.xpm
EA ./textures/fake_wall_east.xpm

F  220,100,0
C  225,30,0


             111      1111     111
        11111101111111100111111101
        10000000001100000000000011
        1011000001110000000000001
        1001000000000000000000001
111111111011000001110000000000001
100000000011000001110111111111111
11110111111111011100000010001
11110111111111011101010010001
11000000110101011100000010001
10000000000000001100000010001
10000000000000001101010010001111
11000001110101011111011110N01
11110111 1110101 101111010001
11111111 1111111 111111111111
